B____B_S__
__B_____B_
_GB___B___
_B___BB__B
__BS_B
___B_B___G
B_____GBB_
__BB_____B